10000000000000000000
11000000000000000000
01110000000000000000
00011000000000000000
00011000000000000000
00011000000000000000
00011000000000000000
00011000000000000000
00011000000000000000
00000010000000000000
00000010011100000000
00000000000000000000
00000000000110000000
00000000000011000000
00000000000001100000
00000000000000110000
00000000000000010000
00000000000000001100
00000000000000000100
00000000000000000000
